DDP	NNG
ㅆㄱㅈ	NNG
가락시장역점	NNP
가산디지털단지역점	NNP
가성비	NNP
강남역점	NNP
강동구청점	NNP
강추	NNG
개롱역점	NNP
개인적으로	MAG
개판	VA
건고추	NNP
건대입구역점	NNP
건더기	NNP
겉바속촉	NNG
경희대점	NNP
계란프라이	NNP
고기	NNG
고기베이스	NNG
고기육수	NNP
고기짬뽕	NNP
고대안암점	NNP
고척동양대점	NNP
고추가루	NNG
고추기름	NNP
고추짜장	NNG
고추짜장	NNP
고추짬뽕	NNP
고추짬뽕밥	NNP
공기밥	NNP
관악구청점	NNP
관악난곡점	NNP
교대역점	NNP
구로디지털단지역점	NNP
구로시장점	NNP
구로항동점	NNP
구의역점	NNP
구파발역점	NNP
굿	VA
금천시흥사거리점	NNP
기름	VA
기본적으로	MAG
깊은맛	NNG
까치산역점	NNP
깔꼼	VA
깔끔	VA
꿔바로우	NNG
꿔바로우	NNP
끈적	VA
낙성대역점	NNP
날파리	NNG
남자사장	NNP
남자직원	NNP
넓었	VV
노량진점	NNP
노원역남부점	NNP
누린내	NNG
눅눅	VA
느글	VA
느끼	VA
늦게	VA
다칠	VV
단골아이템	NNG
달라	VV
달아	VV
담배냄새	NNG
답십리역점	NNP
당산역점	NNP
대학로점	NNP
더러워	VA
더럽	VA
덜익은	VA
덥다	VV
독립문점	NNP
독산홈플러스점	NNP
동대문점	NNP
동묘역점	NNP
등촌시장점	NNP
딱딱	VA
레시피	NNG
마른상태	NNG
만만춘	NNP
많아	VV
말모	NNG
맛없	VV
맛있	VV
맛편차	NNG
매장직원	NNG
머리카락	NNG
면빨	NNG
명동점	NNP
명일동점	NNP
목이버섯	NNG
무난한	VA
바삭	VA
반접시	NNG
발산역점	NNP
방화사거리점	NNP
배식구	NNG
벌레	NNG
별로	VA
별루	VA
보라매공원점	NNP
볶음면	NNG
볶음짬뽕	NNP
북가좌점	NNP
분할결제	NNG
불맛	NNG
불어	VV
불었	VV
불친절	VA
불향	NNG
비위생	VA
비추	NNG
빈그릇	NNG
뿔어	VV
사가정역점	NNP
사당역점	NNP
삶아	VV
삼양사거리점	NNP
상봉역점	NNP
상암DMC점	NNP
상태	VA
서초역점	NNP
선릉역점	NNP
성수역점	NNP
성신여대점	NNP
셀프바	NNG
소상공인	NNP
송파구청점	NNP
수유역점	NNP
시그니처	NNG
시큼	VA
시판면	NNG
식감	NNG
식감꽝	NNG
신	VA
신대방삼거리역점	NNP
신림고시촌점	NNP
신림역점	NNP
신사역점	NNP
신촌2호점	NNP
신풍점	NNP
싱겁	VV
싸ㄱㅈ	NNG
싸가지	VA
싹수	VA
쓰레기	VA
씁쓸	VA
씨부레	NNG
아차산역점	NNP
안좋	VV
압구정역점	NNP
약수역점	NNP
양	VA
양천구청점	NNP
어랍쇼	NNG
어쩔수없이	MAG
없다	VV
에어컨	NNG
여자사장	NNP
여자직원	NNP
연신내역점	NNP
연유꽃빵	NNP
염창역점	NNP
영등포역점	NNP
예의	NNG
외대점	NNP
용산문배점	NNP
우장산역점	NNP
위생	NNP
위생관리	NNG
육즙	NNG
의심	NNG
이물질	NNG
이수역점	NNP
인성	NNG
일반짬뽕	NNG
일원점	NNP
자동계산기	NNG
자잦면	NNG
잠실새내점	NNP
잡내	VA
잤다	VV
재료소진	NNG
잼봉	NNG
쟁반짜장	NNP
저녁식사	NNG
점바점	NNG
점심식사	NNG
정신	VA
조리상태	NNG
조아	VV
존맛탱	NNG
좋은말	NNG
중국식탕수육	NNG
중앙대점	NNP
질겨	VV
질겼	VV
짜다	VV
짜장	NNG
짜장면	NNG
짜장밥	NNG
짜장소스	NNG
짜장소스	NNP
짠	VV
짬봉	NNG
짬뽕	NNG
짬뽕국물	NNG
짬뽕면	NNP
짬뽕밥	NNG
짬짜면	NNP
짰	VV
쫀득	VA
찹살탕수육	NNP
찹쌀 탕수육	NNG
찹쌀탕수육	NNG
창동역점	NNP
청소	NNG
초파리	NNG
최악	NNG
최악	VA
추천메뉴	NNG
춥다	VV
카드결제	NNG
카드이용	NNG
칼칼	VA
콤보메뉴	NNP
탄	VA
탄맛	NNG
탄탄면	NNG
탕수육	NNG
탕수육콤보볶음면	NNG
탕짜면	NNP
탕짬면	NNP
탕짬밥	NNP
탱탱한	VA
털	NNG
테이블정리	NNG
튀김만두	NNG
튀김상태	NNG
튀김옷	NNG
튼실	VA
평소에는	VA
평타	NNG
푸짐	VA
한남점	NNP
한양대점	NNP
해물	NNG
해물짬뽕	NNP
해쉬브라운	NNP
혼밥	NNG
혼잣말	NNG
홍대입구역점	NNP
홍콩반점	NNP
홍콩반점	NNG
화곡역점	NNP
화장실냄새	NNG
회전율	NNG
후회	VA